                                                          |  
                           #/##(                          | 
                          ((/ ,(/                         | 
                          #(#&&@(                         | 
                          (@&&(                           |
                          .//*// ,(*/#                    | 
                     //(.&%%#%(,&//*#*                    |
                   ,*** ,%#/,, */,/(,,*..                 | 
                   /*,,,/*/(#*(//%**#,,*                  | 
                   *(/@/@/,,#*#*,*&@@(#*.                 | 
                   //@&&/*,**//*/*#%*@/                   | 
                   (##% %///(/#((//  *(                   |
                   ,((&  (((*//(//%  &*,,/                | 
                  /,(&  &%%(#%(*(((   &/.#                | 
                  *#(.  %(((#/##**(    &***               | 
                   **.  %#(#%(%#((/(    %/*               | 
                   *(. (&(#&&/&&*/#%.  ,.(.               | 
                   .*  /#/%&&&&&(((#   ,%/                | 
                       .%(#&&&&&/(/#                      | 
                     ,**,/@&&&&&@@*(**                    | 
                     */,,*@&&&&&@**,,*                    | 
                      *, /@&&&&&&/*.,/                    | 
                     .,,,/&& & *&%*,,*                    | 
                      ((/,%.    %/***/                    | 
                      ,#/(#     &%##*                     | 
                       //#%      #(/,                     | 
                       **%       ##**                     | 
                      #/(/(      #(//,                    | 
                  ,((*/((%%(((///&((%////,                | 
                  ((@@@@@@%((((((&@@&(((/(                |
=========================================================== 