%%%%%###################################################%#%%%%%%%%%%%%%%%%%%%%%|
%%%#########################################################%%%%%%%%%%%%%%%%%%%|
%%#############################%%%%%%%%%%###################%%%#%%%%%%%%%%%%%%%|
%######################%%%%%###((((((((((#%####################%%%%%%%%%%%%%%%%|
################%%####((******,............,####################%%%%%%%%%%%%%%%|
################((/*****....,**,,,,,,..*(#(######################%%%%%%%%%%%%%%|
##############(/****......,,******,.,((###########################%%%%%%%%%%%%%|
############(//*.....    .....,****,,**/#########################%%/*#%%%%%%%%%|
###########(/*,.            . .,,****,,,*/#######################%%//#%%%%%%%%%|
#######%%(/**,.              ...,///**,, ,/(#######################%%%%%%%%%%%%|
#########/*,,..             ..,**(((/**,...,((((#####################%%%%%%%%%%|
#####%#((**..              .,,,,*((((((/*,..  ..((#########(######%##%%%%%%%%%%|
#####%#((**,..                  ,((((((((/**...  .(#####/*,.,#######%%%%%%%%%%%|
#####%#******.                  ,((((((((((/*,.     (#/*,...  .....#%%#%%%%%%%%|
#####%#******.                 .,((((((((((/*,. . ..(#%%(*,......#%##%%%%%%%%%%|
#######/*****.                ..,((((((((/*,.   ..(######%%%%%%%%####%#%%%%%%%%|
#####%#((**.                 .,****((((((*   . .####################%%%%%%%%%%%|
#####%#((**....            .,***/(((((//*,.      .(###################%%%%%%%%%|
#########/***,               ...,(((/**, . ,##########################%%%%%%%%%|
#########((/*,.              .,**(/***,,.*############################%%%%%%%%%|
###########(/*,.             .,**/***,,*/(################%##########%%%%%%%%%%|
#############(/*,,,.. .. ..,,,,***,,...,/(###############((//#%######%%%%%%%%%%|
##############((/**,......,,,*****,....  ,/////(########(/*,,((#%###%%%%%%%%%%%|
################((////**,...,**,,,,,,...  ..,,,,#########%#/*,*#%%#%%%%%%%%%%%%|
######################((/*****,..........,,*###############%%%%%#%%%%%%%%%%%%%%|
##############################(*****/##########################%%%%%%%%%%%%%%%%|
###############################################################%%%%%%%%%%%%%%%%|
%############################################################%%%%%%%%%%%%%%%%%%|
%%%%#######################################################%%%%%%%%%%%%%%%%%%%%|
================================================================================