%%%%%%%%%%%%%%%%%%%%%%%%%%%%%%%%%%%%%%%%%%%%%%%%%%%%%%%%###%%%%%%%%%%%%%%%%%%%|
%%%%%%%%%%%%%%%###%%%%%%%%%#########################%%%%###%%%%%%%%%%%%%%%%%%%|
%%%%%%%%%%%%%%%%%%%%%%%%%###//*****////*//***//////#%%%%%%%%%%##%%%%%%%%%%%%%%|
%%%%%%%%%%%%%%%%%##########/,,...................,,(##########%%%%%%%%%%%%%%%%|
%%%%%%%%%%%%%%%##(/////////*,,...................,,*/////////(##%%%%%%%%%%%%%%|
%%%%%%%%%%%%%%%##/,,,,,,,,,,.......................,,,,,,,,**/##%%%%%%%%%%%%%%|
%%%%%%%%%%%%%%%##*,,.......................................,,/####%%%%%%%%%%%%|
%%%%%%%%%%%%%%%##*,,.......,,,*******************,,........,,/####%%%%%%%%%%%%|
%%%%%%%%%%%%%%%##*,,.......*((%%%%%%%%%%%%%%%%%##((,.......,,/##%%##%%%%%%%%%%|
%%%%%%%%%%#####((*.....,,,,*##%%###(((((((((#####((*,,,,...,,*((#####%%%%%%%%%|
%%%##%%%%%#//****,....*//(((##%%##/,,,,,,,**/##%%##(((//,....,****//#%%%%%%%%%|
%%%%%%%%%%(**.......,,*((#####%%((,       ..*((%%%%###((*.......,,**#%%%%%%%%%|
%%%%%%%%%%(**.......,,*##%%#####((,         ,((#####%%((*.........**(%%%%%%%%%|
%%%%%%%%%%(**.......,,*####(//****.         .****//#%%((*.........**(%%%%%%%%%|
%%%%%%%%%%(**.......,,/####/..                   ,,(%%##*.........**(%%%%%%%%%|
%%%%%%%%%%(**.......,,/####/..                   ,,(%%##*.........**(%%%%%%%%%|
%%%%%%%%%%(**.......,,/####/..                   ,,(%%##*.........**#%%%%%%%%%|
%%%%%%%%%%(**.......,,/####/..                   ,,(%%##*.........**#%%%%%%%%%|
%%%%%%%%%%(**.......,,/####(**,,...         ...,,**(%%##*.........**(%%%%%%%%%|
%%%%%%%%%%(**.......,,/##%%#((((//,         ,//((((#%%((*.........**#%%%%%%%%%|
%%%%%%%%%%(**,,,,.....*((#####%%((*.........*#########((*....,,,,,//#%%%%%%%%%|
%%%%%%%%%%#((////,....,****/##%%##(/////////(######/****,....*////((#%%%%%%%%%|
%%%%%%%%%%#####((*.......,,*((%%#################((*.......,,/((#####%%%%%%%%%|
%%%%%%%%%%%%%%%##*.........*((###################((,.......,,/##%%%%%%%%%%%%%%|
%%%%%%####%%%%%##*.........,**///////////////////**,.......,,/##%%%%%%%%%%%%%%|
%%%%%%%%%%%%%%%##*,,.......................................,,/##%%%%%%%%%%%%%%|
%%%%%%%%%%%%%%%##(*********,.......................**********(##%%%%%%%%%%%%%%|
%%%%%%%%%%%%%%%#####(((((((/,,...................,,/(((((((((###%%%%%%%%%%%%%%|
%%%%%%%%%%%%%%%%%%%%%%%%%##(,,...................**(%%%%%%%##%%%%%%%%%%%%%%%%%|
%%%%%%%%%%%%%%%%%%%%%%%%%##(**,,,,,,,,,,,,,,,,,,,**(%%%%%%%%%%%%%%%%%%%%%%%%%%|
%%%%%%%%%%%%%%%%%%%%%%%%%%%#(((((((((((((((((((((((#%%%%%%%%%%%%%%%%%%%%%%%%%%|
%%%%%%%%%%%%%%%%%%%%%%%%%%%#%%%%%%%%%%%#%%%%%##%%%%%%%%%%%%%%%%%%%%%%%%%%%%%%%|
%%%%%%%%%%%%%%%%%%%%%%%%%###%%%%%%%%%%%#%%%%%%%%%%%%%%%%%%%%%%%%%%%%%%%%%%%%%%|
===============================================================================