///////////////////////////////////////////////////////////////////////////////|
///////////////////////////////////////////////////////////////////////////////|
///////////////////////////////////////////////////////////////////////////////|
//////////////////////////////////#####################((((((((/..*////////////|
//////////////////////////////////////////#############%%#((((((((*.....///////|
//////////////////////////////////////////((((((##((###%%%(((((/*,*//,..,,,////|
///////////////////////////////////////////////(##((####%#(((((/..*((,....,////|
//////////////////////////////////////////////////###%####(((.....*((,....,////|
///////////////////////////////////////////////##%%####((((((..,(((##,....,////|
//////////////////////////////////////////(((((########(((///,,*(((#(,..,,,////|
//////////////////////////////////////////%%%#%###((((((((,..((((((((...///////|
//////////////////////////////////########%%###(((((/../(((((((/.....//////////|
//////////////////////(%##########%#######(((((*..(((((((((((..,///////////////|
//////////////////////(##############%####(((((*..(((((((((((..,///////////////|
///////////(########################(((%%%%%%%%#(((((((*../////////////////////|
///###%####%#############%%%%%%%%%%%%%%%%%(((((*.,/////////////////////////////|
///////////(%#%%%%%%%%%%%%%%%%%%%%%%(((////////////////////////////////////////|
///////////(##%%%%%%%%%%%%%%%%%%%%%%(((////////////////////////////////////////|
================================================================================