%%%%%%%%%%%%%%%%########################################%%%%%%%%%%%%%%%%%%%%%%%|
%%%%%%%%%%%%%%######################((((((((((###########%%%%%%%%%%%%%%%%%%%%%%|
%%%%%%%%%%%########################(.           *##########%%%%%%%%%%%%%%%%%%%%|
%%%%%%%%%################(//*                     .(########%%%%%%%%%%%%%%%%%%%|
%%%%%%%##############/,,,                    ***.   /##########%%%%%%%%%%%%%%%%|
%%%%%############(***,          ......     .,(((*  ,(############%%%%%%%%%%%%%%|
%%%%############,.  .....                  ..((((/((###############%%%/.(%%%%%%|
%%%###########. ......                       ((((((((((############%%%%#%%%%%%%|
%###########* .....                           ./((((((((############%%%%%%%%%%%|
%#########( ../(,.                             //(((((((((###########%%%%%%%%%%|
##########/ *(((.                               ,//((((((((###########%%%%%%%%%|
########/  ,/((/.                               ./*   //((((###########%%%%%%%%|
#######(/ .(((,...       ....                     ./.  ./((((##########%%%%%%%%|
######(. ,*(*.,,.. ...,/////*,.                     ,*(((((((#(//  .../#%%%%%%%|
######(..((,,*((,.   ,////////*                       /((((((#(////#####%%%%%%%|
######(..(/ .,/(,.   .////////*                       ,,/(((((##########%%%%%%%|
######(..(/  ...      .*////*..        .***.            /(((((###########%%%%%%|
######(..(((((((.                 *//////,              /(((((######*   (#%%%%%|
######(..(((((((.             .////////*..            //(((((#####(       #%%%%|
######(..(((((((..///////.  ,////////*.               /(((((((########/    .#%%|
######(. .,((((((((*.,//////*.  *////*.             */(((((((############%%%%%%|
########/ .(((((((/*.*(////     ..//////..       .,//(((((((############%%%%%%%|
########/  .*((((/ ,(((///*    .*////////,      ,///((((((((###########%%%%%%%%|
##########( ,/(((/.*(/*/(.    ./////////       .*/((((((((##########(/(%%%%%%%%|
%#########(/, ,*(/ ... ..   ,*//(/////,,.      /((((((((((##########(/(%%%%%%%%|
%%##########/*. ,**,     ***/(((((((*,..     ,*(((((((((############%%%%%%%%%%%|
%%%%##########((. .*(////(((((((((((,.       (((((((((#############%%%%%%%%%%%%|
%%%%%############(       .,(((((((,.....   /((((* ,(##############%%%%%%%%%%%%%|
%%%%%#############(((*          ......       (((*   /##########%#%%%%%%%%%%%%%%|
%%%%%%%%#################                           /##########%%%%%%%%%%%%%%%%|
%%%%%%%%%%##################*                     ,##########%%%%%%%%%%%%%%%%%%|
%%%%%%%%%%%%########################,...........*##########%%%%%%%%%%%%%%%%%%%%|
%%%%%%%%%%%%%%%##########################################%%%%%%%%%%%%%%%%%%%%%%|
================================================================================