&&&&&&&&&##((%%%%%####%#((((##(((((*(((((((((((((####%##%##%((#####%&&&&&&&&&&&|
&&&&&&&####%#%#%%##%%###%#((((((((/,*///((/((###%#%#%###%########%#%&&&&&&&&&&&|
&&&&&%##%####%%##%%#%(%#(#*/%&&&&&&/%&&&&&&&&((/(#%&%&#####%%###%%%&&&&&&&&&&&&|
&&&&&%###%%####&%%&&(#&&&&&&&&%/, .*%&&&&&&&&&&&(#%%%&&&%######%&&&&%%&&&&&&&&&|
&&&&%&%%%#(#####%#%&&&&%&&&&&&&&///*,.*//,*&@@&@&&&&&%%&%%%%%####%%%%%#%%%&&&&&|
&&&%%%%&%%%%(#(#%#%#%&&%&&&&&&%*///(/*((*//*&&&&&&&&&%%%#&&&(%((#%%%%%#%%%%&&&&|
&&&%%%%%%%%#%(/#&&%%#(%%&&&&&&/##%%%%*#&&&&%%&&&&&&&#%%%&&/##%%&&&&%%%&&&&&&&&&|
&&&%&%&&%&&%%(#&&&%%%%#(&&&&&%&&&&%*%&&&&&&&&&&&#%%%%%&&&(%%&&&&&%%%&&&&&&&&&&&|
&&&&%&&%%%%&%(#&&&%%%&%%##%&&&&&&&&&%*%&&&&&&&&&(&&%%%%%&&&(%%%&&&&&%&&&&&&&&&&|
&&&&%&&&%%%%%(%%&&%%%%%%&(&&&&&&&&%*#&&&&&&&&(#&&&&%%%%%%&%%%%%%&&&&&&&&&&&&&&&|
&&&&&&&&%%%%%##&&&%%%%%%&&&/%&&&&&%,#&&&&&&((&&&&&&%%%%%&&&&%%#%%&&&&&&&&&&&&&&|
&&&&&&&&%%%%%%&&&&%%%%%%&&&&&&(/%%%%#,#%&&%((&&&&&&&&%%%%%%&&&&%%%&&&&&&&&&&&&&|
&&&&&&&&%%%%%%%%%%%%%%%%&&&&&&&%/*(//.*(#//%&&&&&&&&&%%%%%&&&&&%%%&&&&&&&&&&&&&|
&&&&&&&&%%%%%%%%%%%%%%%%&&&&%%%##/,,.&,.,/#%%&&&&&&&&%%%%%&&&&&%%%&&&&&&&&&&&&&|
&&&%%%%%####(###((//////(((((((/**,*%*/,,,/((((((((((///(((####%((##%%%&&&&&&&&|
%&&&&&&&%%%%%%&&&&%%%%%%%%%&%%%%#(* %&% ,/#%%%&&&&&&&%#%%%%&&&&%%%%&&&&&&&&&&&&|
%%%&%%&&%%%%%&&&&&%%%%%%&&&%%%%%(**/,(,/*,#%%&&&&&&&&%#%%%%%&&&%%%&&&&&&&&&&&&&|
%%%%%%&&%%%%%%%%%%%#%%%%%%%%%%%/(###(.(#%%(/#%&&&&&&&%#%%%%%&&&%#%%%%&&&%%%%%%%|
%%%%%%&&%%%%%%%%%%###%%#%%%%%/(%%%%%#,#%%%%%((%%%%%%&%###%%%%%%%#%%%%&&%%%%%%%%|
%%%%%%&&%%%%%%%%%%###%##%%%((%%%%%%%#,(%%%%%%%((%%%%%#####%%%%%%%%%%%&&%%%%%%%%|
######&&%%####%%%%#######(/#######%%#,(%%###%%%%(/#%%######%%%%%#%%%%%#########|
######&#########(####/(#########%##,(###########(/#%#####%((((##%#%%&(#########|
((((((%%#####(((((#(#/(##########((((,/(((((((((((#(((#####%((((#%%#%%&/(((((((|
***///%%#####/////#(/###//((////////*,**/////////////%#(###%////%%%%%%&/*******|
,,,,,*%%#####***,,(#####,,,,******,,,.,,,,,,,,,******%###(#%****%%%#%%%,,,,,,,,|
      %%###((..  .#(###(     ....              ......#######... %#%#%%%        |
      ##((((#     ((((#(                             (##((##    %###%##        |
,,,**&%&&&&&&%,,,%%%%%%%%,,,,,***,,,,.,,,,**********#%%#&&&&%,,%%%&&&&&&,,,,,,,|
%%%%&%&&&&&&&&&&%%%%%%&@&%&&&%////*//,***//*/(%%%%%%%&&&%%%&&&&&%%&&&&&&&&%%%%%|
%%#((((#####%%&&@&&&&&&%%%(////((////*////////////(%#%%&%&&&&&@&%%%%%%%%%&%%%%#|
%%%%%&@@@@@@&&&&&&&&&&@@@&&&&&&&&&&&&&&&&&&&&&&&&&@@@@&&&@&%&&&&@@@@@@&&&&%%%%%|
%%&%%%&&&&@@@@@@@@@@@&&@&&&&&&&&&&&&%#%&&&&&&&&&&&&&&&@@@@@@@@@@@@@@@@@@@&&&&%%|
&&&%%%%%%%%%%%%%%%%%%&#((((//**////*/////////((#####&@@@@&@&@@&&&&&&&&&&&&&&%%%|
&%&%%%%%%%%%&&&&&&&&&&%&&&&&&&&&&&&&&&&&&&&&&&&&&&&&&&&&&&&&&&&&&&&&&&&&&&&&&&&|
#%&%%%%%%%%%&&&&&&&&&&(((////***,,,,...,,***////((((((##&&&&&&&&&&@@@&&@@@@&%#(|
%%%&%%%%%###%%%&&&%%&&&&&(/***,..    ..,**,*****/(##&&@@@@@&&&&&%%&&&&&&&%%%%%%|
================================================================================